"filename", "language", "C++", "C", "comment", "blank", "total"
"e:\robomaster\RM2021\Infantry_code\Infantry_Neptune_Code\Infantry_Neptune\Core\Inc\Algorithm\adrc_alg.h", "C++", 43, 0, 9, 18, 70
"e:\robomaster\RM2021\Infantry_code\Infantry_Neptune_Code\Infantry_Neptune\Core\Inc\Algorithm\ahrs_alg.h", "C++", 18, 0, 9, 10, 37
"e:\robomaster\RM2021\Infantry_code\Infantry_Neptune_Code\Infantry_Neptune\Core\Inc\Algorithm\crc_alg.h", "C++", 26, 0, 9, 12, 47
"e:\robomaster\RM2021\Infantry_code\Infantry_Neptune_Code\Infantry_Neptune\Core\Inc\Algorithm\filter_alg.h", "C++", 35, 0, 9, 12, 56
"e:\robomaster\RM2021\Infantry_code\Infantry_Neptune_Code\Infantry_Neptune\Core\Inc\Algorithm\kalman_alg.h", "C++", 59, 0, 14, 15, 88
"e:\robomaster\RM2021\Infantry_code\Infantry_Neptune_Code\Infantry_Neptune\Core\Inc\Algorithm\math_alg.h", "C++", 45, 0, 22, 13, 80
"e:\robomaster\RM2021\Infantry_code\Infantry_Neptune_Code\Infantry_Neptune\Core\Inc\Algorithm\pid_alg.h", "C++", 58, 0, 11, 18, 87
"e:\robomaster\RM2021\Infantry_code\Infantry_Neptune_Code\Infantry_Neptune\Core\Inc\Chassis_Control\cha_chassis_ctrl.h", "C++", 65, 0, 9, 18, 92
"e:\robomaster\RM2021\Infantry_code\Infantry_Neptune_Code\Infantry_Neptune\Core\Inc\Chassis_Control\cha_gimbal_ctrl.h", "C++", 56, 0, 9, 17, 82
"e:\robomaster\RM2021\Infantry_code\Infantry_Neptune_Code\Infantry_Neptune\Core\Inc\Chassis_Control\cha_power_ctrl.h", "C++", 39, 0, 9, 16, 64
"e:\robomaster\RM2021\Infantry_code\Infantry_Neptune_Code\Infantry_Neptune\Core\Inc\Chassis_Control\cha_referee_ctrl.h", "C++", 41, 0, 9, 16, 66
"e:\robomaster\RM2021\Infantry_code\Infantry_Neptune_Code\Infantry_Neptune\Core\Inc\Code_specification.h", "C++", 0, 0, 181, 2, 183
"e:\robomaster\RM2021\Infantry_code\Infantry_Neptune_Code\Infantry_Neptune\Core\Inc\Common_Contrrol\buscomm_cmd.h", "C++", 33, 0, 9, 16, 58
"e:\robomaster\RM2021\Infantry_code\Infantry_Neptune_Code\Infantry_Neptune\Core\Inc\Common_Contrrol\buscomm_ctrl.h", "C++", 90, 0, 18, 22, 130
"e:\robomaster\RM2021\Infantry_code\Infantry_Neptune_Code\Infantry_Neptune\Core\Inc\Common_Contrrol\init_ctrl.h", "C++", 12, 0, 9, 8, 29
"e:\robomaster\RM2021\Infantry_code\Infantry_Neptune_Code\Infantry_Neptune\Core\Inc\Common_Contrrol\watchdog_ctrl.h", "C++", 12, 0, 9, 10, 31
"e:\robomaster\RM2021\Infantry_code\Infantry_Neptune_Code\Infantry_Neptune\Core\Inc\Const\const.h", "C++", 127, 0, 29, 45, 201
"e:\robomaster\RM2021\Infantry_code\Infantry_Neptune_Code\Infantry_Neptune\Core\Inc\Const\infantry3_const.h", "C++", 13, 0, 9, 10, 32
"e:\robomaster\RM2021\Infantry_code\Infantry_Neptune_Code\Infantry_Neptune\Core\Inc\Const\infantry4_const.h", "C++", 13, 0, 9, 9, 31
"e:\robomaster\RM2021\Infantry_code\Infantry_Neptune_Code\Infantry_Neptune\Core\Inc\Const\infantry5_const.h", "C++", 13, 0, 9, 8, 30
"e:\robomaster\RM2021\Infantry_code\Infantry_Neptune_Code\Infantry_Neptune\Core\Inc\Const\infantry6_const.h", "C++", 13, 0, 9, 9, 31
"e:\robomaster\RM2021\Infantry_code\Infantry_Neptune_Code\Infantry_Neptune\Core\Inc\Const\infantry7_const.h", "C++", 13, 0, 9, 9, 31
"e:\robomaster\RM2021\Infantry_code\Infantry_Neptune_Code\Infantry_Neptune\Core\Inc\Const\infantry8_const.h", "C++", 13, 0, 9, 10, 32
"e:\robomaster\RM2021\Infantry_code\Infantry_Neptune_Code\Infantry_Neptune\Core\Inc\FreeRTOSConfig.h", "C++", 57, 0, 74, 18, 149
"e:\robomaster\RM2021\Infantry_code\Infantry_Neptune_Code\Infantry_Neptune\Core\Inc\Gimbal_Control\gim_client_ctrl.h", "C++", 40, 0, 9, 15, 64
"e:\robomaster\RM2021\Infantry_code\Infantry_Neptune_Code\Infantry_Neptune\Core\Inc\Gimbal_Control\gim_gimbal_ctrl.h", "C++", 68, 0, 9, 20, 97
"e:\robomaster\RM2021\Infantry_code\Infantry_Neptune_Code\Infantry_Neptune\Core\Inc\Gimbal_Control\gim_ins_ctrl.h", "C++", 51, 0, 9, 25, 85
"e:\robomaster\RM2021\Infantry_code\Infantry_Neptune_Code\Infantry_Neptune\Core\Inc\Gimbal_Control\gim_login_ctrl.h", "C++", 41, 0, 9, 16, 66
"e:\robomaster\RM2021\Infantry_code\Infantry_Neptune_Code\Infantry_Neptune\Core\Inc\Gimbal_Control\gim_miniPC_ctrl.h", "C++", 54, 0, 9, 20, 83
"e:\robomaster\RM2021\Infantry_code\Infantry_Neptune_Code\Infantry_Neptune\Core\Inc\Gimbal_Control\gim_remote_ctrl.h", "C++", 40, 0, 9, 13, 62
"e:\robomaster\RM2021\Infantry_code\Infantry_Neptune_Code\Infantry_Neptune\Core\Inc\Gimbal_Control\gim_shoot_ctrl.h", "C++", 90, 0, 9, 25, 124
"e:\robomaster\RM2021\Infantry_code\Infantry_Neptune_Code\Infantry_Neptune\Core\Inc\Library\buff_lib.h", "C++", 18, 0, 9, 10, 37
"e:\robomaster\RM2021\Infantry_code\Infantry_Neptune_Code\Infantry_Neptune\Core\Inc\Library\font_lib.h", "C++", 12, 0, 9, 8, 29
"e:\robomaster\RM2021\Infantry_code\Infantry_Neptune_Code\Infantry_Neptune\Core\Inc\Library\list_lib.h", "C++", 34, 0, 9, 12, 55
"e:\robomaster\RM2021\Infantry_code\Infantry_Neptune_Code\Infantry_Neptune\Core\Inc\Library\log_lib.h", "C++", 10, 0, 9, 10, 29
"e:\robomaster\RM2021\Infantry_code\Infantry_Neptune_Code\Infantry_Neptune\Core\Inc\Library\str_lib.h", "C++", 15, 0, 9, 8, 32
"e:\robomaster\RM2021\Infantry_code\Infantry_Neptune_Code\Infantry_Neptune\Core\Inc\Peripheral\BMI0xx_reg.h", "C++", 206, 0, 17, 55, 278
"e:\robomaster\RM2021\Infantry_code\Infantry_Neptune_Code\Infantry_Neptune\Core\Inc\Peripheral\imu_periph.h", "C++", 121, 0, 9, 25, 155
"e:\robomaster\RM2021\Infantry_code\Infantry_Neptune_Code\Infantry_Neptune\Core\Inc\Peripheral\key_periph.h", "C++", 21, 0, 9, 11, 41
"e:\robomaster\RM2021\Infantry_code\Infantry_Neptune_Code\Infantry_Neptune\Core\Inc\Peripheral\led_periph.h", "C++", 29, 0, 9, 14, 52
"e:\robomaster\RM2021\Infantry_code\Infantry_Neptune_Code\Infantry_Neptune\Core\Inc\Peripheral\magnetic_periph.h", "C++", 43, 0, 9, 14, 66
"e:\robomaster\RM2021\Infantry_code\Infantry_Neptune_Code\Infantry_Neptune\Core\Inc\Peripheral\miniPC_periph.h", "C++", 49, 0, 11, 18, 78
"e:\robomaster\RM2021\Infantry_code\Infantry_Neptune_Code\Infantry_Neptune\Core\Inc\Peripheral\motor_periph.h", "C++", 98, 0, 14, 27, 139
"e:\robomaster\RM2021\Infantry_code\Infantry_Neptune_Code\Infantry_Neptune\Core\Inc\Peripheral\oled_periph.h", "C++", 40, 0, 9, 19, 68
"e:\robomaster\RM2021\Infantry_code\Infantry_Neptune_Code\Infantry_Neptune\Core\Inc\Peripheral\referee_periph.h", "C++", 356, 0, 34, 71, 461
"e:\robomaster\RM2021\Infantry_code\Infantry_Neptune_Code\Infantry_Neptune\Core\Inc\Peripheral\remote_periph.h", "C++", 64, 0, 9, 19, 92
"e:\robomaster\RM2021\Infantry_code\Infantry_Neptune_Code\Infantry_Neptune\Core\Inc\Peripheral\sensor_periph.h", "C++", 38, 0, 12, 16, 66
"e:\robomaster\RM2021\Infantry_code\Infantry_Neptune_Code\Infantry_Neptune\Core\Inc\Peripheral\servo_periph.h", "C++", 30, 0, 9, 15, 54
"e:\robomaster\RM2021\Infantry_code\Infantry_Neptune_Code\Infantry_Neptune\Core\Inc\SuperCap_Control\supercap_ctrl.h", "C++", 45, 0, 9, 16, 70
"e:\robomaster\RM2021\Infantry_code\Infantry_Neptune_Code\Infantry_Neptune\Core\Inc\Utility\adc_util.h", "C++", 19, 0, 9, 14, 42
"e:\robomaster\RM2021\Infantry_code\Infantry_Neptune_Code\Infantry_Neptune\Core\Inc\Utility\can_util.h", "C++", 19, 0, 9, 10, 38
"e:\robomaster\RM2021\Infantry_code\Infantry_Neptune_Code\Infantry_Neptune\Core\Inc\Utility\dac_util.h", "C++", 30, 0, 9, 14, 53
"e:\robomaster\RM2021\Infantry_code\Infantry_Neptune_Code\Infantry_Neptune\Core\Inc\Utility\flash_util.h", "C++", 39, 0, 10, 15, 64
"e:\robomaster\RM2021\Infantry_code\Infantry_Neptune_Code\Infantry_Neptune\Core\Inc\Utility\gpio_util.h", "C++", 55, 0, 9, 25, 89
"e:\robomaster\RM2021\Infantry_code\Infantry_Neptune_Code\Infantry_Neptune\Core\Inc\Utility\i2c_util.h", "C++", 19, 0, 9, 9, 37
"e:\robomaster\RM2021\Infantry_code\Infantry_Neptune_Code\Infantry_Neptune\Core\Inc\Utility\pwm_util.h", "C++", 32, 0, 9, 13, 54
"e:\robomaster\RM2021\Infantry_code\Infantry_Neptune_Code\Infantry_Neptune\Core\Inc\Utility\spi_util.h", "C++", 24, 0, 9, 12, 45
"e:\robomaster\RM2021\Infantry_code\Infantry_Neptune_Code\Infantry_Neptune\Core\Inc\Utility\uart_util.h", "C++", 22, 0, 9, 11, 42
"e:\robomaster\RM2021\Infantry_code\Infantry_Neptune_Code\Infantry_Neptune\Core\Inc\adc.h", "C++", 12, 0, 27, 14, 53
"e:\robomaster\RM2021\Infantry_code\Infantry_Neptune_Code\Infantry_Neptune\Core\Inc\can.h", "C++", 14, 0, 27, 14, 55
"e:\robomaster\RM2021\Infantry_code\Infantry_Neptune_Code\Infantry_Neptune\Core\Inc\configure.h", "C++", 104, 0, 48, 35, 187
"e:\robomaster\RM2021\Infantry_code\Infantry_Neptune_Code\Infantry_Neptune\Core\Inc\dac.h", "C++", 12, 0, 27, 14, 53
"e:\robomaster\RM2021\Infantry_code\Infantry_Neptune_Code\Infantry_Neptune\Core\Inc\dma.h", "C++", 11, 0, 28, 14, 53
"e:\robomaster\RM2021\Infantry_code\Infantry_Neptune_Code\Infantry_Neptune\Core\Inc\gpio.h", "C++", 11, 0, 27, 12, 50
"e:\robomaster\RM2021\Infantry_code\Infantry_Neptune_Code\Infantry_Neptune\Core\Inc\i2c.h", "C++", 14, 0, 27, 14, 55
"e:\robomaster\RM2021\Infantry_code\Infantry_Neptune_Code\Infantry_Neptune\Core\Inc\main.h", "C++", 98, 0, 41, 19, 158
"e:\robomaster\RM2021\Infantry_code\Infantry_Neptune_Code\Infantry_Neptune\Core\Inc\spi.h", "C++", 12, 0, 27, 14, 53
"e:\robomaster\RM2021\Infantry_code\Infantry_Neptune_Code\Infantry_Neptune\Core\Inc\stm32f4xx_hal_conf.h", "C++", 277, 0, 130, 86, 493
"e:\robomaster\RM2021\Infantry_code\Infantry_Neptune_Code\Infantry_Neptune\Core\Inc\stm32f4xx_it.h", "C++", 31, 0, 36, 16, 83
"e:\robomaster\RM2021\Infantry_code\Infantry_Neptune_Code\Infantry_Neptune\Core\Inc\tim.h", "C++", 33, 0, 27, 15, 75
"e:\robomaster\RM2021\Infantry_code\Infantry_Neptune_Code\Infantry_Neptune\Core\Inc\usart.h", "C++", 20, 0, 27, 14, 61
"e:\robomaster\RM2021\Infantry_code\Infantry_Neptune_Code\Infantry_Neptune\Core\Src\Algorithm\adrc_alg.c", "C", 0, 84, 39, 28, 151
"e:\robomaster\RM2021\Infantry_code\Infantry_Neptune_Code\Infantry_Neptune\Core\Src\Algorithm\ahrs_alg.c", "C", 0, 143, 68, 35, 246
"e:\robomaster\RM2021\Infantry_code\Infantry_Neptune_Code\Infantry_Neptune\Core\Src\Algorithm\crc_alg.c", "C", 0, 133, 63, 23, 219
"e:\robomaster\RM2021\Infantry_code\Infantry_Neptune_Code\Infantry_Neptune\Core\Src\Algorithm\filter_alg.c", "C", 0, 44, 35, 11, 90
"e:\robomaster\RM2021\Infantry_code\Infantry_Neptune_Code\Infantry_Neptune\Core\Src\Algorithm\kalman_alg.c", "C", 0, 274, 155, 60, 489
"e:\robomaster\RM2021\Infantry_code\Infantry_Neptune_Code\Infantry_Neptune\Core\Src\Algorithm\math_alg.c", "C", 0, 96, 59, 18, 173
"e:\robomaster\RM2021\Infantry_code\Infantry_Neptune_Code\Infantry_Neptune\Core\Src\Algorithm\pid_alg.c", "C", 0, 99, 81, 50, 230
"e:\robomaster\RM2021\Infantry_code\Infantry_Neptune_Code\Infantry_Neptune\Core\Src\Chassis_Control\cha_chassis_ctrl.c", "C", 0, 189, 104, 65, 358
"e:\robomaster\RM2021\Infantry_code\Infantry_Neptune_Code\Infantry_Neptune\Core\Src\Chassis_Control\cha_gimbal_ctrl.c", "C", 0, 107, 72, 53, 232
"e:\robomaster\RM2021\Infantry_code\Infantry_Neptune_Code\Infantry_Neptune\Core\Src\Chassis_Control\cha_power_ctrl.c", "C", 0, 72, 40, 24, 136
"e:\robomaster\RM2021\Infantry_code\Infantry_Neptune_Code\Infantry_Neptune\Core\Src\Chassis_Control\cha_referee_ctrl.c", "C", 0, 211, 140, 88, 439
"e:\robomaster\RM2021\Infantry_code\Infantry_Neptune_Code\Infantry_Neptune\Core\Src\Common_Contrrol\buscomm_cmd.c", "C", 0, 223, 11, 37, 271
"e:\robomaster\RM2021\Infantry_code\Infantry_Neptune_Code\Infantry_Neptune\Core\Src\Common_Contrrol\buscomm_ctrl.c", "C", 0, 315, 72, 74, 461
"e:\robomaster\RM2021\Infantry_code\Infantry_Neptune_Code\Infantry_Neptune\Core\Src\Common_Contrrol\init_ctrl.c", "C", 0, 68, 22, 33, 123
"e:\robomaster\RM2021\Infantry_code\Infantry_Neptune_Code\Infantry_Neptune\Core\Src\Common_Contrrol\watchdog_ctrl.c", "C", 0, 35, 16, 10, 61
"e:\robomaster\RM2021\Infantry_code\Infantry_Neptune_Code\Infantry_Neptune\Core\Src\Const\const.c", "C", 0, 207, 41, 61, 309
"e:\robomaster\RM2021\Infantry_code\Infantry_Neptune_Code\Infantry_Neptune\Core\Src\Const\infantry3_const.c", "C", 0, 97, 29, 27, 153
"e:\robomaster\RM2021\Infantry_code\Infantry_Neptune_Code\Infantry_Neptune\Core\Src\Const\infantry4_const.c", "C", 0, 97, 29, 30, 156
"e:\robomaster\RM2021\Infantry_code\Infantry_Neptune_Code\Infantry_Neptune\Core\Src\Const\infantry5_const.c", "C", 0, 97, 29, 30, 156
"e:\robomaster\RM2021\Infantry_code\Infantry_Neptune_Code\Infantry_Neptune\Core\Src\Const\infantry6_const.c", "C", 0, 97, 29, 30, 156
"e:\robomaster\RM2021\Infantry_code\Infantry_Neptune_Code\Infantry_Neptune\Core\Src\Const\infantry7_const.c", "C", 0, 97, 29, 30, 156
"e:\robomaster\RM2021\Infantry_code\Infantry_Neptune_Code\Infantry_Neptune\Core\Src\Const\infantry8_const.c", "C", 0, 97, 29, 30, 156
"e:\robomaster\RM2021\Infantry_code\Infantry_Neptune_Code\Infantry_Neptune\Core\Src\Gimbal_Control\gim_client_ctrl.c", "C", 0, 204, 59, 55, 318
"e:\robomaster\RM2021\Infantry_code\Infantry_Neptune_Code\Infantry_Neptune\Core\Src\Gimbal_Control\gim_gimbal_ctrl.c", "C", 0, 170, 78, 59, 307
"e:\robomaster\RM2021\Infantry_code\Infantry_Neptune_Code\Infantry_Neptune\Core\Src\Gimbal_Control\gim_ins_ctrl.c", "C", 0, 174, 43, 48, 265
"e:\robomaster\RM2021\Infantry_code\Infantry_Neptune_Code\Infantry_Neptune\Core\Src\Gimbal_Control\gim_login_ctrl.c", "C", 0, 213, 43, 52, 308
"e:\robomaster\RM2021\Infantry_code\Infantry_Neptune_Code\Infantry_Neptune\Core\Src\Gimbal_Control\gim_miniPC_ctrl.c", "C", 0, 211, 121, 62, 394
"e:\robomaster\RM2021\Infantry_code\Infantry_Neptune_Code\Infantry_Neptune\Core\Src\Gimbal_Control\gim_remote_ctrl.c", "C", 0, 340, 120, 94, 554
"e:\robomaster\RM2021\Infantry_code\Infantry_Neptune_Code\Infantry_Neptune\Core\Src\Gimbal_Control\gim_shoot_ctrl.c", "C", 0, 302, 145, 94, 541
"e:\robomaster\RM2021\Infantry_code\Infantry_Neptune_Code\Infantry_Neptune\Core\Src\Library\buff_lib.c", "C", 0, 36, 47, 15, 98
"e:\robomaster\RM2021\Infantry_code\Infantry_Neptune_Code\Infantry_Neptune\Core\Src\Library\font_lib.c", "C", 0, 228, 11, 7, 246
"e:\robomaster\RM2021\Infantry_code\Infantry_Neptune_Code\Infantry_Neptune\Core\Src\Library\list_lib.c", "C", 0, 98, 62, 54, 214
"e:\robomaster\RM2021\Infantry_code\Infantry_Neptune_Code\Infantry_Neptune\Core\Src\Library\log_lib.c", "C", 0, 1, 9, 2, 12
"e:\robomaster\RM2021\Infantry_code\Infantry_Neptune_Code\Infantry_Neptune\Core\Src\Library\str_lib.c", "C", 0, 46, 20, 14, 80
"e:\robomaster\RM2021\Infantry_code\Infantry_Neptune_Code\Infantry_Neptune\Core\Src\Peripheral\imu_periph.c", "C", 0, 321, 118, 125, 564
"e:\robomaster\RM2021\Infantry_code\Infantry_Neptune_Code\Infantry_Neptune\Core\Src\Peripheral\key_periph.c", "C", 0, 48, 19, 14, 81
"e:\robomaster\RM2021\Infantry_code\Infantry_Neptune_Code\Infantry_Neptune\Core\Src\Peripheral\led_periph.c", "C", 0, 29, 42, 15, 86
"e:\robomaster\RM2021\Infantry_code\Infantry_Neptune_Code\Infantry_Neptune\Core\Src\Peripheral\magnetic_periph.c", "C", 0, 71, 34, 29, 134
"e:\robomaster\RM2021\Infantry_code\Infantry_Neptune_Code\Infantry_Neptune\Core\Src\Peripheral\miniPC_periph.c", "C", 0, 177, 75, 63, 315
"e:\robomaster\RM2021\Infantry_code\Infantry_Neptune_Code\Infantry_Neptune\Core\Src\Peripheral\motor_periph.c", "C", 0, 369, 174, 85, 628
"e:\robomaster\RM2021\Infantry_code\Infantry_Neptune_Code\Infantry_Neptune\Core\Src\Peripheral\oled_periph.c", "C", 0, 205, 96, 55, 356
"e:\robomaster\RM2021\Infantry_code\Infantry_Neptune_Code\Infantry_Neptune\Core\Src\Peripheral\referee_periph.c", "C", 0, 598, 296, 194, 1088
"e:\robomaster\RM2021\Infantry_code\Infantry_Neptune_Code\Infantry_Neptune\Core\Src\Peripheral\remote_periph.c", "C", 0, 128, 79, 36, 243
"e:\robomaster\RM2021\Infantry_code\Infantry_Neptune_Code\Infantry_Neptune\Core\Src\Peripheral\sensor_periph.c", "C", 0, 36, 37, 22, 95
"e:\robomaster\RM2021\Infantry_code\Infantry_Neptune_Code\Infantry_Neptune\Core\Src\Peripheral\servo_periph.c", "C", 0, 33, 48, 23, 104
"e:\robomaster\RM2021\Infantry_code\Infantry_Neptune_Code\Infantry_Neptune\Core\Src\SuperCap_Control\supercap_ctrl.c", "C", 0, 102, 54, 39, 195
"e:\robomaster\RM2021\Infantry_code\Infantry_Neptune_Code\Infantry_Neptune\Core\Src\Utility\adc_util.c", "C", 0, 17, 26, 14, 57
"e:\robomaster\RM2021\Infantry_code\Infantry_Neptune_Code\Infantry_Neptune\Core\Src\Utility\can_util.c", "C", 0, 71, 49, 27, 147
"e:\robomaster\RM2021\Infantry_code\Infantry_Neptune_Code\Infantry_Neptune\Core\Src\Utility\dac_util.c", "C", 0, 34, 33, 19, 86
"e:\robomaster\RM2021\Infantry_code\Infantry_Neptune_Code\Infantry_Neptune\Core\Src\Utility\flash_util.c", "C", 0, 159, 47, 34, 240
"e:\robomaster\RM2021\Infantry_code\Infantry_Neptune_Code\Infantry_Neptune\Core\Src\Utility\gpio_util.c", "C", 0, 96, 39, 32, 167
"e:\robomaster\RM2021\Infantry_code\Infantry_Neptune_Code\Infantry_Neptune\Core\Src\Utility\i2c_util.c", "C", 0, 53, 56, 22, 131
"e:\robomaster\RM2021\Infantry_code\Infantry_Neptune_Code\Infantry_Neptune\Core\Src\Utility\pwm_util.c", "C", 0, 50, 38, 23, 111
"e:\robomaster\RM2021\Infantry_code\Infantry_Neptune_Code\Infantry_Neptune\Core\Src\Utility\spi_util.c", "C", 0, 107, 81, 44, 232
"e:\robomaster\RM2021\Infantry_code\Infantry_Neptune_Code\Infantry_Neptune\Core\Src\Utility\uart_util.c", "C", 0, 87, 94, 34, 215
"e:\robomaster\RM2021\Infantry_code\Infantry_Neptune_Code\Infantry_Neptune\Core\Src\adc.c", "C", 0, 82, 62, 30, 174
"e:\robomaster\RM2021\Infantry_code\Infantry_Neptune_Code\Infantry_Neptune\Core\Src\can.c", "C", 0, 101, 78, 42, 221
"e:\robomaster\RM2021\Infantry_code\Infantry_Neptune_Code\Infantry_Neptune\Core\Src\dac.c", "C", 0, 38, 51, 28, 117
"e:\robomaster\RM2021\Infantry_code\Infantry_Neptune_Code\Infantry_Neptune\Core\Src\dma.c", "C", 0, 22, 42, 14, 78
"e:\robomaster\RM2021\Infantry_code\Infantry_Neptune_Code\Infantry_Neptune\Core\Src\freertos.c", "C", 0, 162, 203, 54, 419
"e:\robomaster\RM2021\Infantry_code\Infantry_Neptune_Code\Infantry_Neptune\Core\Src\gpio.c", "C", 0, 42, 46, 22, 110
"e:\robomaster\RM2021\Infantry_code\Infantry_Neptune_Code\Infantry_Neptune\Core\Src\i2c.c", "C", 0, 76, 74, 43, 193
"e:\robomaster\RM2021\Infantry_code\Infantry_Neptune_Code\Infantry_Neptune\Core\Src\main.c", "C", 0, 123, 114, 38, 275
"e:\robomaster\RM2021\Infantry_code\Infantry_Neptune_Code\Infantry_Neptune\Core\Src\spi.c", "C", 0, 78, 55, 31, 164
"e:\robomaster\RM2021\Infantry_code\Infantry_Neptune_Code\Infantry_Neptune\Core\Src\stm32f4xx_hal_msp.c", "C", 0, 7, 55, 25, 87
"e:\robomaster\RM2021\Infantry_code\Infantry_Neptune_Code\Infantry_Neptune\Core\Src\stm32f4xx_hal_timebase_tim.c", "C", 0, 34, 65, 13, 112
"e:\robomaster\RM2021\Infantry_code\Infantry_Neptune_Code\Infantry_Neptune\Core\Src\stm32f4xx_it.c", "C", 0, 125, 210, 74, 409
"e:\robomaster\RM2021\Infantry_code\Infantry_Neptune_Code\Infantry_Neptune\Core\Src\system_stm32f4xx.c", "C", 0, 346, 321, 83, 750
"e:\robomaster\RM2021\Infantry_code\Infantry_Neptune_Code\Infantry_Neptune\Core\Src\tim.c", "C", 0, 473, 249, 157, 879
"e:\robomaster\RM2021\Infantry_code\Infantry_Neptune_Code\Infantry_Neptune\Core\Src\usart.c", "C", 0, 276, 174, 104, 554
"Total", "-", 3415, 9681, 6635, 4357, 24088